111111111
1P00100C1
100000011
100000011
100100C11
11000E011
100100C11
111000011
100100C11
111111111