111111111111111111
100000000000P00001
1111000C0000000111
111100100000000111
110000001000011111
100000C00000000111
111100000000E00111
111100000C00000111
111111111111111111