1111111111111111111111111111111111
1E0000001000000C00000C0000R0000001
1010010100100000101001000000010101
10100100101010100010010000R0010101
1P00R0000C00C000000R000000000000C1
1111111111111111111111111111111111