111111111
1P0100C11
100000011
1000R0011
10010EC11
110000011
100100C11
1110R0011
100100C11
111111111